+-+-+-+-+-+-+-+-+-+-+-+-+-+-+-+-+-+-+-+-+-+-+-+-+-+-+-+-+-+-+-+-+-+-+-+-+-+-+-+-+
      |   |   |         |   |     |   |       |   |       | |   |   |         | |
+-+-+ +-+ + + + +-+-+-+ + + + +-+ +-+ +-+-+-+ + + +-+ + + + + + +-+ +-+ +-+-+ + +
|     |   | |   |     |   | |   |   |     |   | |   | | |   | |         | |   | |
+ +-+-+ + + +-+-+ +-+-+-+-+ + +-+-+ +-+ + + +-+ +-+ + + +-+-+ +-+-+-+-+-+ + +-+ +
| | |   |   |     |         | |   | | | | | |   | | | | |   | |     |     |     |
+ + + +-+-+-+ + +-+ +-+-+-+-+ + + + + + +-+ + +-+ + +-+ + + + +-+-+ +-+-+ +-+-+ +
| |   |     | | |   |   |     | |   |   |   |   |   |   | | |     |       |   | |
+ + + + +-+ + + + +-+ + + +-+ + +-+-+ +-+ +-+-+ +-+-+ +-+ + +-+-+ +-+-+ +-+ +-+ +
|   | |   | | | |     |   |   |           |   | |   |   | | |   |   | | |       |
+-+-+ +-+ + +-+ +-+ +-+-+-+ +-+-+-+-+-+-+-+ + + + + +-+ + + + +-+-+ + + +-+-+-+-+
|     | | |   | |   |     |       |     |   |   | |   | | |       |   |   |     |
+-+-+ + + +-+ + + +-+ +-+ +-+-+-+ + + + + +-+-+-+ +-+ + + +-+-+-+ + +-+-+ + +-+ +
|       |   |   |   |   |   |       | | |   |   | |   | |     | | | |     | | | |
+ +-+-+-+ +-+-+-+ + +-+ +-+ +-+-+-+-+ + +-+ + + +-+ +-+ +-+-+ + + + + +-+-+ + + +
|   |   |         | | |   |       |   | | | | | |   | | |   | | |   | |       | |
+-+ + +-+-+-+-+-+-+ + +-+ +-+-+-+ + +-+ + + +-+ + +-+ + + + + + + +-+ +-+-+-+-+ +
|   |       |       | |     |   | |   | | | |   | |   | | |   | |   |           |
+ +-+-+ +-+ + +-+-+-+ + + + + + + +-+ + + + + +-+ + +-+ + + +-+ +-+ +-+-+-+-+-+ +
|     | |   |       |   | |   | |   | | | | |   |     | | | | |     |         | |
+-+-+ + +-+-+-+-+-+ +-+-+-+-+ +-+-+ + + + + +-+ + +-+ + +-+ + +-+-+-+ +-+-+-+ + +
| |   |         |   |     | |     |   | |       | |   |   | |   |   |     | |   |
+ + +-+-+-+-+ + + +-+-+ + + +-+-+ +-+-+ +-+ +-+-+-+ + +-+ + +-+ + + + +-+ + +-+-+
|   | |       |   | |   | |       |     |   |   |   |   |   |   | |   |   |     |
+-+-+ + +-+-+-+-+-+ + +-+ +-+-+-+-+ +-+-+ +-+ + + +-+-+ + +-+ +-+ +-+-+ +-+-+-+ +
|   | |     |   |   | | |   |   |   |   |   | | | |     |     |   |   |   |     |
+ + + +-+ + + + + +-+ + +-+ + + + +-+ + +-+ +-+ + + + +-+ +-+-+ +-+ + +-+ + +-+-+
| | |     |   | |     |   | | |   |   |   |   |   | | |   |     | | |   | |     |
+ + +-+-+-+ +-+ + +-+-+-+ + +-+ +-+ +-+ +-+-+ + +-+ + + +-+ +-+-+ + +-+ + +-+-+ +
| | | |     |   | |     | |   |     |   |     | |   |   | |         |   |       |
+ + + + + +-+ +-+ +-+ + + +-+ +-+-+-+ +-+ +-+-+ + +-+-+-+ + + +-+-+-+ +-+-+-+-+-+
| | |   |   | |   |   |   |     |     |   |   | |   |   |   | |       |   |     |
+ + +-+-+ + + + +-+ +-+-+ +-+-+ + +-+-+ +-+ + + +-+ + + +-+-+ + + +-+-+ + + +-+ +
| | |   | | | |   | |     |     | |     |   | | |   | | |   | | | |     |   |   |
+ + +-+ +-+ + +-+-+ + +-+-+ +-+-+ + +-+-+ +-+ + + +-+ + + + + + + + +-+-+-+-+ +-+
| |   |     |       |     |   | | |     |   |   |   | | | | | | |   |       |   |
+ +-+ +-+-+-+-+-+-+-+-+-+ +-+ + + + +-+ +-+ +-+-+-+ + + + +-+ + +-+-+ +-+-+ +-+ +
|   | |       |       |   | |   |   |     | |   |   | |   |   |       |     |   |
+-+ + + +-+-+ +-+ + +-+ +-+ +-+ +-+-+ +-+-+ + + + +-+ + +-+ +-+ +-+-+-+ +-+-+ +-+
|   |       |     |             |           | |       |     |   |       |        
+-+-+-+-+-+-+-+-+-+-+-+-+-+-+-+-+-+-+-+-+-+-+-+-+-+-+-+-+-+-+-+-+-+-+-+-+-+-+-+-+