+-+-+-+-+-+-+-+-+-+-+
  |                 |
+ + +-+-+-+ +-+-+-+ +
|   |     | |   | | |
+-+-+ +-+ + + + + + +
|     | |   | | |   |
+ +-+-+ +-+-+-+ + +-+
| |           | |   |
+ + +-+-+ +-+ + +-+ +
| | |   |   | | |   |
+ + + + +-+-+ + + +-+
| | | | |   |   |   |
+ + + +-+ + +-+-+-+-+
| | |     | |       |
+ + + +-+-+ + +-+-+ +
|   | |     | |   | |
+ +-+ +-+ +-+ + +-+ +
| |   |   |   |     |
+ +-+-+ +-+ +-+ +-+-+
|           |        
+-+-+-+-+-+-+-+-+-+-+